10	10	10	10	10	10	10	10	10
10	0	0	0	0	0	2	0	10
10	0	0	0	0	2	3	2	10
10	2	2	0	0	2	3	2	10
10	3	3	2	0	0	2	0	10
10	2	2	10	0	0	0	0	10
10	0	0	10	0	0	0	0	10
10	0	0	0	0	0	0	0	10
10	0	0	0	0	0	0	0	10
10	0	10	10	0	0	0	0	10
10	0	0	0	0	0	0	0	10
10	0	0	0	0	0	0	0	10
10	10	10	10	10	10	10	10	10
